Megjelenés dátuma, helyszíne: 28 August 2014 (Australia)
Főszereplők: 

	Ethan Hawke	Ethan Hawke	...	The Barkeep
	Sarah Snook	Sarah Snook	...	The Unmarried Mother
	Christopher Kirby	Christopher Kirby	...	Mr. Miles
	Christopher Sommers	Christopher Sommers	...	Mr. Miller
	Kuni Hashimoto	Kuni Hashimoto	...	Dr. Fujimoto
	Sara El-Yafi	Sara El-Yafi	...	Lab Technician
	Paul Moder	Paul Moder	...	Boxing Commentator 1
	Grant Piro	Grant Piro	...	Boxing Commentator 2 / News Report Announcer
	Christopher Bunworth	Christopher Bunworth	...	Jerry
	Jamie Gleeson	Jamie Gleeson	...	Dirty Hippy
	Christina Tan	Christina Tan	...	Female Reporter
	Dennis Coard	Dennis Coard	...	Mayor Davidson
	Milla Simmonds	Milla Simmonds	...	Baby Jane 1
	Ruby Simmonds	Ruby Simmonds	...	Baby Jane 1
	Cate Wolfe	Cate Wolfe	...	Beth
	Adok ide nevet	látod?	Józsi

Rendező: Michael Spierig
Operatőr: Ben Nott
Tartalom összefoglalása: A legendás Robert A. Heinlein (többek között a Csillagközi invázió írója) novellájából készült filmben egy időügynök (Ethan Hawke) barangol múltban és jövőben: minden bevetés más korba vezeti. Egy olyan bűnözőre vadászik, aki valahogy folyton kicsúszik a kezéből, bármilyen időben is készül lecsapni rá.
Trailer: https://www.youtube.com/watch?v=YzIvd9YjpL8
Forgatási helyszín: Ausztrália
Zenéjét szerezte: Peter Spierig

Jelölések:
	AACTA Award
(4th)[28]	Best Film	Paddy McDonald	Nominated
Tim McGahan	Nominated
The Spierig Brothers	Nominated
Best Direction	Nominated
Best Adapted Screenplay	Nominated
Best Actress	Sarah Snook	Won
Best Cinematography	Ben Nott	Won
Best Editing	Matt Villa	Won
Best Original Music Score	Peter Spierig	Nominated
Best Production Design	Matthew Putland	Won
Best Costume Design	Wendy Cork	Nominated